Level 29:

colon - ორწერტილი
semicolon - წერტილმძიმე
comma - მძიმე
curly braces - ფიგურული ბრჩხილები
CSS Rule - კოდი რომელიც სტილავს ელემენტებს
Selector - 
Declaration - კუთვნილებისა და მნიშვნელობის წყვილი
Property - კუთვნილებისა
Value - მნიშვნელობა
parent - მშობელი
child - შვილი
descendant - შთამომავალი
inheritance - მემკვიდრეობა

Level 31:



Level 33:

RGB - Red, Green, Blue
Hex - თექვსმეტობითი
measuring unit - საზომი ერთეული
pixel - ეკრანის საზომი ერთეული

Level 35:

text-decoration - ტექსტის დეკორაცია
text-decoration-style - ტექსტის დეკორაციის სტილი
text-decoration-line - ტექსტის დეკორაციის ხაზი
text-decoration-color - ტექსტის დეკორაციის ფერი
text-transform - ტექსტის გარდაქმნა
text-shadow - ტექტსტის ჩრდილი
dotted - წერტილოვანი
dashed - წყვეტილი
wavy - ტალღური

Level 37:

font-family - შრიფტის ტიპი
font-weight - შრიფტის სისქე
fallback - სათადარიგო

Level 39:

state - მდგოამრეობა
pseudo selectors - სელექტორები რომლებიც სტილავენ ელემენტების კონკრეტულ მდგოამრეობას
hover - მდგომარეობა როდესაც კურსორი არის ელემენტზე
active - მდგომარეობა როდესაც ხდება ელემენტზე დაწოლა
link - მდგომარეობა, აქტიურა სანამ მოხმარებელი ბმულზე გადავა
visited - ბმულის მდგომარეობა, აქტიურა მას შემდეგ რაც მომხმარებელი ბმულზე გადავა

Level 47:

position - მდებაორება
top - ზევით
bottom - ქვემოთ
right - მარჯვნივ
left - მარცხნივ
fixed - გაწერილი
corner - კუთხე
relative - ნათესაური კავშირი

Level 49:

background - ფონი
repeat - გამეორება
contain - შეიცავს
cover - დაფარვა

Level 51:

hover - მდგოამრეობა როდესაც კურსორი ძევს ელემენტზე
active - მდგომაროება როდესაც კურსორით ვაჭერთ ელემენტს
focus - მდგოამრეობა როდესაც ელემენტი ყურადღების ცენტრშია
transform - გარდაქმნა
translate - გადათარგმნა, გადატანა
scale - სკლარიება, ზომის გადიდება
skew - გაწელვა
rotate - მობრუნება
degree - გრადუსი
clockwise - საათის ისრის მიმართულებით
counter - საწინააღმდეგო
transition - გარდამავალი/გადასვლა
duration - ხანგრძლივობა
delay - დაყოვნება
trigger - გამომწვევი